EA /path_to_the_east_texture.xpm
WE /path_to_the_west_texture.xpm
SO /path_to_the_south_texture.xpm
NO /path_to_the_north_texture.xpm

F 220,100,0
C 255,120,0


          11111111
         100000001
        1000111001
       10001  1001
      10001   1001                 111111111111
     10001    1001              1111000000000001111
    10001     1001           1110000011111111000000111
   1001       1001         1100000011        11000000011
  100011111111100111111111100000001            100000001
 100000000000000000000000000000001             100000001
1111111111111110011111111100000001            1000000001
             10001       11111111            1000000001
             10001                          1000000001
             10001                         1000000001
             10001                        1000000001
             10001                       1000000001
             11111                      1000000001
                                       1000000001
                                      10000000011111111111
                                     100000000000000000001
                                    1000000000000000000001
                                   11111111111111111111111