WE textures/colectible.xpm
EA textures/player_right.xpm
SO textures/ground.xpm
NO textures/wall.xpm

F 135,206,250
C 108,123,139


111111111111111
100000000000001
10N000000000001
100000000000001
100001110000001
100000000000001
100000000000001
100000000000001
100000000000001
111111000000001
100000000000001
100000010101001
100000010000001
100000010000001
111111111111111