EA /path_to_the_east_texture.xpm
WE /path_to_the_west_texture.xpm
SO /path_to_the_south_texture.xpm
NO /path_to_the_north_texture.xpm

F 220,100,0
C 255,120,0


111111111111111
10S000000000001
100000000000001
100000000000001
100001110000001
100000000000001
100000000000001
100000000000001
100000000000001
111111000000001
100000000000001
100000010101001
100000010000001
100000010000001
111111111111111