WE textures/wall_cpy_4.xpm
EA textures/wall_cpy_2.xpm
SO textures/wall_cpy_3.xpm
NO textures/wall.xpm

C 108,123,139
F 135,206,250

111111111111111
100000000100001
100000000000001
100111111100001
100000000100001
100000000100001
100000000000001
100000000000001
100000000000001
111111111100001
100000000000001
100000010101001
10N000010000001
100000010000001
111111111111111