EA textures/dirt_1.xpm
WE textures/wood_1.xpm
SO textures/diamond.xpm
NO textures/creeper.xpm

F 135,206,250
C 108,161,51


                            111111111111111111111111111111111111
                            100000000000000000000000000000000001
                            111111111110000100001111111000000001
1111111111111111111111111             10001000001     1000000001
1000000000000000000000001             10000100001     1000000N01
1000000000000000000000001111111111111110000010001111111000000001
1111111110000111111000000000000000000000000000000000000000000001
     100000001    1000000000000011111111111111111111111111111111
     100000001    100000000000001
     1000000011111100000000000001
     1000000000000000000000011111
111111111000000000000000000000001
100000001000000100000000111111111
1000000000000001000000001
1000000000000001000000001
1111111111111111111111111