EA /path_to_the_east_texture.xpm
WE /path_to_the_west_texture.xpm
SO /path_to_the_south_texture.xpm
NO /path_to_the_north_texture.xpm

F 220,100,0
C 255,120,0


                            111111111111111111111
                            100000000000000000001
                            111111111110000000001
1111111111111111111111111             10000000001
10E0000000000000000000001             10000000001
1000000000000000000000001111111111111110000000001
1111111110000000000000000000000000000000000000001
        10000000000000000000000011111111111111111
        1000000000000000000000001
        1000000000000000000000001
        1000000000000000000000001
111111111000000000000000000000001
100000000000000000000000111111111
1000000000000000000000001
1111111111111111111111111