EA /path_to_the_east_texture.xpm
WE /path_to_the_west_texture.xpm
SO /path_to_the_south_texture.xpm
NO /path_to_the_north_texture.xpm

F 220,100,0
C 255,120,0

1111111111111111111111111
10N0000000000000000000001
1111111111111111111111111