EA /path_to_the_east_texture.xpm
WE /path_to_the_west_texture.xpm
SO /path_to_the_south_texture.xpm
NO /path_to_the_north_texture.xpm

F 220,100,0
C 255,120,0


                            11111111111111111111111111111111
                            10000000000000000000000000000001
                            11111111111000000000111111111001
1111111111111111111111111             1000000000111111111001
10E0000000000000000000001             1000000000111111111001
100000000000000000000000111111111111111000000000111111111001
111111111000000000000000000000000000000000000000000000000001
        1000000111100000000000001111111111111111111111111111
        10000001  100000000000001
        1000000111100000000000001
        1000000000000000000011111
111111111000000000000000000000001
100000001000000100000000111111111
1000000000000001000000001
1111111111111111111111111